133
+++++++++++++++++++++++++++++++++++++++++++++++++++++++++++++++++++++++++++++++++++++++++++++++++++++++++++++++++++++++++++++++++++++
+     +   +       +   +       +   +             + +   +   +         +   +         +     +   +       +             +   +   +   +     +
+++++ + +++ +++++ + +++ +++++ + +++ +++++++++ + + + + + + + +++++++ +++ + +++++++ +++ + + + + + +++ + +++++++++++ + + + + + + + +++ +
+     +     +   +     +     + +     +   +   + +   + +   +   +       +   +   +   + +   +   + + +   +   +   +   +   + +   + + +   + + +
+ +++++++ +++ + +++++ +++++++ +++++++ +++ + + +++++ +++++++++ +++++++ +++++ + +++ + +++++++ + +++ + +++ + + + + +++++ +++ + +++++ + +
+   +   + + + +       +     + +     +     +       + + +     + +     + +   + +     +     +   +   + +   + +   + + +   + +   + +     + +
+ + + + + + + +++++ +++ +++ + + +++ +++++++++++++ + + + +++ + + +++ + + +++ + +++++++++ + +++++ + +++ + +++++ + + + + + +++ + +++++ +
+ +   + +   + +   +       +   + +       + +     + +   +   + + +   +     +   +         + +     + +   + +   +   +   + + +   +     +   +
+ +++++ +++++ +++ +++++ +++++++ + +++++ + + +++ + + +++++ + + +++ +++++ + +++++++++ +++ +++++ + +++ +++++ + +++++++ + +++ +++ + + +++
+   +   +   +   + +   +       + +     + + + +   + +       + + +       +     +       +   +   + + +   +     +   +   +   +   +   + + + +
+++ + +++ + +++ + + +++++++ + + +++++ + + + + +++ +++++++++ + +++++++++++ + + +++++++ +++++ + + + +++ +++++++ + + +++++++++++++++ + +
+   +   + +     + +         + +   + + + +   +   +           + +       +   + +       + +     + + + +   +     + + + +   +       +   + +
+ +++++ + +++++++ +++++++++ + +++ + + + +++ +++ +++++++++ +++ + +++++ +++++ +++++++ + + +++ + + + + +++ +++ + + + + + + +++++ + +++ +
+ +   +   +     +   +       +     +   +       + +       + +   +     +   +   +       + +   + + + + +     + + +   +   +   +     +     +
+ +++ + +++ +++ +++ + +++++++++ +++++++++++++++ + +++++++ + +++++++ +++ + +++ +++++++ +++ +++ + + +++++ + + +++ +++ +++++ +++++ +++++
+   + + +   +   +   +   +     + +       +       + +       +   +   +   + +   + +         +     + +   +   + +   + +   +   +     + +   +
+ + + + + +++ +++ +++++++ +++ +++ +++++ + +++++++ +++ +++++++ +++ +++ + +++ + + +++++ +++++++++ +++ + +++ +++ +++ +++ + +++ + + + + +
+ +   +   + +     +     +   +       +   +             +   +   +   + + +     +   +   +   +   +   +   + +   +   +   +   +     +     + +
+ +++++++++ +++ +++++++ +++ +++++ + +++++++++++++ +++++ + + +++ +++ + +++++++++++ + +++ + + + +++ +++ + +++ + + +++ + +++++++++++++++
+ +   +         +   + +     +   + +   +         + +     +   +   +   +   +     +   + +   + +   +   +   + +   + + + + + +     +   +   +
+ +++ + +++++++++ + + +++++ + + + +++ + +++++++ +++ + +++++++ +++ + +++ + +++ + +++++ +++ + +++ +++ +++ + +++++ + + +++ +++ + + + + +
+     +     +     +   +     + + + +   +   +   +     +   +   + + + +       +   + +   +     +   +   +     + +       +       + + + + + +
+++++++++++ + +++++ +++ +++++ + + + + +++ +++ +++++++++ + + + + + +++++++++ +++ + + +++++++++ + +++++++++ + +++++++++++++++ + + + + +
+         +   +     +   +   + +   + + + +     +   +     + + + + + +   +   +     + + +         + +         + + +     +   +     + + + +
+ +++++++++++++ + +++ + + + +++++++++ + +++++++ + + +++++ + + + + +++ + + +++++++ +++ +++++++++ + +++++ +++ + + +++ +++ + +++++ +++ +
+ +       +     + +   + + + +   + +   +   +   + +   + +   +   +   +   + + +           +       + +   +   +   +   +   +   +   + +     +
+ + +++++ + +++++++ +++++ + + + + + +++++ + + + +++++ + +++++ + +++ +++ + + +++++ +++++ +++++ + +++ + +++ +++++++ +++ +++++ + +++++++
+   +       + +   +   +   + + + +   +   +   + + +   +   +     + +   +   +   +   +       +     + +   +   + +   + +     +     +     + +
+++++ +++++++ + + +++++ + +++ + +++ + + +++ +++ + + + +++ +++++ + +++++ +++++++ +++ +++++ +++++ + +++++++ + + + +++ +++ +++++ + + + +
+     +     +   + +   + + +   +   + + +   +   +   +   +     +   +     +   +   +   + +   + +     + + +     + +   +       +     + +   +
+ +++++ +++ +++++ + + + +++ +++++ + + +++ +++ +++++++++++++ + +++++++ + + + + +++ +++ + + + +++++ + + +++++ +++++ + +++ +++++++ +++++
+ +     + + +   +   +   +   +     + +   + + +     +       + + +       + +   +     +   +   +   +   +         +     + +   +       +   +
+ + +++++ + + + +++++ +++ +++ +++++ +++ + + +++++ + +++++++ + + +++++ + +++++++ +++ +++++++++ + +++++ +++++++ +++++ +++++ +++ +++ +++
+ + +     + + +         + +   +     +   +   +   + +   + +   + +     + + +     +   +   +       + +   + +   +   +     +     +   +     +
+ + + +++++ +++++++++++ + + +++ +++++++ +++ + + + +++ + + +++ +++++ + + + +++ +++ +++ + +++++++ +++ + + + + +++++++++ +++ +++++++++ +
+ + + +   +   +     +   + +     +     +   +   + + +       +   +     +   +   + + +   + + +     +   +   + + +   +     + + +   +       +
+ + + + + + + +++++ + +++ +++++++ +++ + +++++ +++ + + +++++ +++++++++++++++ + + +++ + + +++++ + + +++++ + +++ + +++ + + +++ + +++++++
+   + + +   + +     +   + +   +   +   + +   + +   + +       +       +     + + + + + + +     + + +   +   + +   +   + + +   + + +   + +
+++++ +++ +++ + +++ +++ + + + + +++ +++++ + + + +++ +++++++ + +++++ + +++ + + + + + + +++++ + +++++ +++++ + +++ +++ + + +++ + +++ + +
+   +   +   + +   +   + +   + +   + +   + +   +         +   +   +   + +   + + + +   + +   + + +   + +     +     +   + +   + + +   + +
+ + +++ +++++ +++ +++ + +++++ + + + + + + +++++++++++++ +++++++ + +++ + +++++ + +++ + +++ + + + +++ + +++++++++++ +++ +++ + + + +++ +
+ +   +           +     +   +   + +   + +   +   + +   +   +   + +     + +   + +     +   +       +   + +         +   +     + + + +   +
+ +++ +++++++ +++++ + +++ + +++++ +++++ +++ + + + + + +++ + + + +++++++ + + + +++++++++ +++ +++++ +++ +++++++++ +++ +++++++ + + + +++
+   + +       +     +     + +   +   +   +   + +   + + +   + + +   +   + + +   +         +   +   +   +       +         +   + + + +   +
+++++ + +++ + + +++++++ +++ + + +++ + + + +++ +++++ + +++++++ +++ + +++ + +++++ +++++++++ +++ + +++ +++++++ +++++++++++ + + + + +++ +
+ +   + +   + + +       + + + +   + + + + + +       +             +   + +       +     + +   + +   +         +     +   + +   + + +   +
+ + +++++ +++++ + +++++++ + + +++++ + +++ + +++++++++++ +++++++++++++ + +++++++++ +++ + +++ + +++ +++++++ +++ +++ + + +++ +++ + + +++
+         +     + +     +   +       + +   + +     +   + +   + +   + + + +       +   + +   + +   +   +     +   +   + +       + + +   +
+++++++++++ +++++ + +++++++++ + +++++ + +++ + + +++ + + + + + + + + + + + +++++ +++ + +++ + +++ +++ + + +++ +++ + + +++++ + + + + + +
+       +   +     +       +   + +   + +   + + +     +   + +   + +   +   + +     +   + +   +   +   +   +     +   + + +     +   +   + +
+ +++++ + +++++ +++++++++ +++++ +++ + +++ + +++ +++++++++ +++++ +++ + +++++ +++++ +++ + +++++ +++ +++++++++++ +++++ + +++++++++++++ +
+     +   +   + +   +   + +   +   + +   +   +   +   +   +   +   + +   +   + +     +   +     +   + +       +     +   + +     +   +   +
+++++ +++++++ + + + + + + + + + + + + + + +++ +++ + + + +++ + +++ +++++ + + + +++++++ +++++ +++ + + +++ +++ +++++ +++ + +++ + + + +++
+   + +       +   + + +     + + +   + +       +   +   +       +   +     + + +   +     +   +       +   + +   +   + + +   + +   +   + +
+ + + +++++ +++++++ +++++ +++++ +++++++++++++++ +++++++++++ +++ +++ +++++ + +++ + +++++ + +++++ +++++++ + +++ + + + +++++ +++ +++++ +
+ +   +   + +       +     +       +     +     + +   +   + +   + +   +     +   + +   +   +     +     +   + +   +   + +       +   +   +
+ +++ + + + + + +++++ +++++ +++++++ +++ + +++ + +++ +++ + +++ + + +++ +++++++ + +++++ +++++++ +++ +++ +++ +++++ +++ + + +++ +++ + +++
+ + +   + + + +   +   +   + +     + +   + +   +     +   +     + +   +         +       +     +     +   + +   +   +   + +   + +   +   +
+ + +++ + + + +++ + +++ + + + +++ + +++ +++ +++ +++++ +++++++++ +++ +++++++++++ +++++++ +++ +++++ + +++ +++ + +++ +++ +++ + +++++++ +
+ + + + +   +   +     + +   +   + +   +     +   +   + +   +   + +             +     +   +   +     + +   +   +   + +   + + +       + +
+ + + + +++++++++++++ + +++++++ + +++ +++++++ +++ +++ + + + + + +++++ + +++++++++++ +++++ + +++++++ + +++ + +++ + +++++ + +++++++ + +
+   + +   +       +   +     +   +   + +       +   +     + + +   +     +       +   + +     + +       +   + + +   +   +           +   +
+++++ +++++ +++++ + +++++++ + +++++ + + +++++++ +++ + +++ + +++++ +++++++++++ + + + + +++++++ +++++ +++ +++ + +++++ +++++++ +++++++++
+   +           +         +   +     + +     + +     + + + +     + +     +   + + +         +   +   +   + +   + +   +         +   +   +
+ + +++++ + +++++++++++++++++ + + +++ +++++ + +++++++ + + +++++ + + +++ +++ + + +++ + +++++ +++ + +++++ + +++ + + + +++++++++ + + +++
+ +       +   +   +           + + +   +   + +   + +   +   +     + + +   +   + + +   + +   + +   +       + +   + +       + +   + +   +
+ +++++++++++ + + + +++++++++++ + + +++ +++ + + + + +++++++++ +++++ + +++ + + + + +++++ + + + + +++++++ + + +++ +++ +++ + + +++ +++ +
+ +   +   + +   +   +     +     + +   + +   + +   +     +   + +     +     +   + +       +   + + +   + +   + +   + + +   + + +   +   +
+ + + + + + + +++++++++ +++ +++++ +++ + + +++ +++ +++ + + + + + +++++ +++++++++ +++++++++++++ +++ + + +++++ + +++ + +++++ + +++++ +++
+ + + + +   +     +   +     + +   +   +     +   +   + +   +     +   +     +     +     + +     +   +   +     + +   +   +     +       +
+ + + + + +++++++ + + +++++++ + +++ +++++ + +++ +++++ +++++++ +++ + + +++ + +++++ +++ + + +++++ +++++++ +++++ + +++++ +++ +++ +++++ +
+ + + + + +   + +   + +   +   +     +   + +   + +   + +         + + +   + +     +   + +   +   +   +     +     + +         +   + +   +
+ +++ + + + + + +++++ +++ + +++++++++++ + +++ + + + + + +++++++++ +++++ +++++++ +++ + +++++++ +++ + +++++ +++++ + +++ +++++ +++ + +++
+       +   +   +   +   +     +     +   + + +     + + +           +   +   +         +   +   +   + +     + +     + +       +   +   + +
+++++ +++++++++ + +++++ +++++ +++++ + +++ + +++++++ + + +++++++++++ +++++ + +++++++++++ +++ +++ + +++ + + + +++++ + + +++ + +++++++ +
+     +   +   + +     +   +   +   +   +   +       +   +     +     +       +       +   +     +         +   +   +   + + +   +     +   +
+ +++++++ + + + + +++ +++ + +++ + + +++ +++++++ +++++++++++ + + +++++++++++++++++ + +++ +++++ + + +++++++++ + +++++ + + +++++ + + +++
+       + + +   +   + +   +   + + + +   +   + +     + +   + + + +             +   +     +   + + +     +   + +     + + +   +   + +   +
+++++++ + + +++++++ + +++ +++ + + + + +++++ + +++++ + + + + + + + +++++++++++ + +++++++++ + +++ +++++++ + +++++++ + + +++ +++++ +++ +
+     + + + +   +   +     +   + + + +     + +       +   +   + +   +   +     +   +     +   +   +       + +   +   + + +   +     +     +
+ +++++ + + + + + +++++++++ + + + + +++++ + +++++ + +++++++++ +++++ + + +++ +++++ +++ + +++++ +++++++ + + + +++ + + +++ +++ +++++++ +
+       +   + + +       +   + + +   +   + +   +   + +       +     + +   +   +   + +   +   + + +     +   + + +   +   +   +           +
+++++++++++++ + + + +++ + +++ + +++ + +++ +++ +++++ + +++++ + +++ + +++++ +++++ + + +++++ + + + +++ +++++ + + + +++++ +++++ +++++++ +
+         +   +   + +   + + +     + +   + +   +   +   + +   +   + +     +     + + +       +     +     +   + + + +   + +   +     +   +
+ +++++++ + +++++++++ + + + + +++ +++++ + + +++ + +++++ + +++++ +++++ + +++++ + + +++ +++++++++++ +++++ + + + + + + + +++ +++++ +++ +
+   +   + +         + +   + +   + +   +     +   + +     +     +       +   +   + + +     +   +   + +     + +   +   + +     + +   +   +
+ +++ + + +++++++++ +++++++ +++ + + + +++ + +++++ + + +++++++ +++++++++ + + +++ + +++++++ + + + + + +++++++++++++++ + +++++ + +++ +++
+     + +           +   +   +   + + +     + +   + + +   +   +     +   + + +   + +   +     + + + + + +   +   +     + +     +   +     +
+++++++ +++++++++++++ + + +++++++++ +++++++++ + + + +++ + + +++++ +++ + + +++ + +++ + +++++ +++ +++ + +++ + + +++++ +++++ +++++ +++++
+   +   +   +     +   +   +       +   +     + + +   + + + +     +   + + +   + + +   +   +   +   +   + +   + +       +   + + +   +   +
+ + + +++ + +++++ + +++++++++ +++ +++ +++++ + + +++++ + + +++++ +++ + + +++ + + + + +++ + +++ +++ +++ + +++ +++++++++ + + + + +++ + +
+ +   +   +   + + +         +   +     +     + +           +   +     + + +   +   + +     + +       +   +   + +   +   + + + + + + + + +
+ +++ + +++++ + + + +++++++ +++ +++++++ +++++ +++++++++++++ + +++++++ +++ +++++++ +++++++ +++ + +++ +++ + + + + +++ + + + + + + + + +
+   +   +     + + + + +   + +   +   +   +       + +   +     + +   +       +     + +     +     +   +     + + + +   +   +   + +     + +
+++ +++++ +++++ + + + + + + + +++ + + +++ + + + + + + + +++++ +++ + + + +++ +++ + + + + +++++++++ +++++++ + + +++ +++++++++ +++ +++ +
+ +   + + +     +   +   +   + +   + + +   + + +     + + +     +   + + + +     + + + + + +   +     +   +   + +   + +       +     +   +
+ +++ + + + +++++++++++++++ + +++ + + + +++++ +++++++ + +++++++ +++ + + + +++ + + + +++ + +++ +++ + + +++++ +++++ +++ +++ +++++++ +++
+ +   +   + +                 +   + +   +     +       +   +     +   + +   +   +     +   +     +   + +   +           + +   +     +   +
+ + +++++++ + +++++++++++++ +++ + + + +++ + +++++ +++++++ + +++++++++++++++ +++++ +++ +++++++++ +++ + + + +++++++++ + + +++ +++ +++ +
+ + +     +   + +       +       + +   +   +   +   +       + +     +   +   + + +   +   +       +     + + +     +   +   +   + + +   + +
+ + + +++ +++++ + + +++ + +++++++++++++ +++++++ +++++ +++++ + +++ + + + + + + + +++ +++++++++ +++++++ + +++++ + +++++++ +++ + +++++ +
+   + + +   + +   +   + +   +           +       +   + +   + + +   + +   + + + + +   +           +     +   +   + +     + +   +     + +
+++++ + +++ + + +++++++ +++++ +++++++++ + +++ +++ + + + + + + +++++++++ + + + + +++++ +++++++ +++ +++++++ + +++ + +++ + + + + +++ + +
+   + +       +   + +   +     +       + +   + +   +   + +   +     +     +   +   +   + +   +     +   +   + +   +     +   + +   + +   +
+ + + +++++++++++ + + +++ +++++ +++++ +++++ +++ +++++ + +++++++++ + +++++++++++++ + + + + +++++ +++ + + + +++ +++++++++++ +++++ +++++
+ +   + +       + +     +           +     +   +     + +       + + +     +         + + + +     +     + +     +       +   + +   +     +
+ +++++ + +++++ +++ +++++++++++ +++++++++ +++ +++++ + + +++++ + + +++++ + +++++++++ + +++++++ +++ +++ +++++++++++ + +++ + +++ +++++ +
+   + +   +   + +     +       + +       +   +       + +     + +   +     + + +       +     +         +         +   +     +   +   +   +
+++ + +++++ + + + + +++ +++++ +++ +++ + +++ +++ +++++ +++++++ +++ + +++++ + + +++++++++++ +++++++++++++ +++++ + +++++++++++ +++ + +++
+   + +     + +   +   + +   +     +   +   + +   +   +   +   +   + +     + + + + +   +   +     + +     + +   +   +     +   +   + + + +
+ + + + +++ +++++ +++ + + + +++++++ +++ +++ + +++ + +++ + + +++ + +++++++ + + + + + +++ + +++ + + +++++ + +++ +++++++ + + +++ + + + +
+ + + +   + +   +   + +   +   +   + + +   + +     +   +   +     +       +   + +   + +   + +     + + +   +   +       +   + +   + + + +
+ + + +++ + + +++++ + +++++ + + + + + +++ + +++++++++ +++++++++++++++++ +++++ +++++ + +++++ +++++ + + +++++ +++++++ +++ + +++ + + + +
+ + + +   + +       +       + + + +   + +   +     + +   +             +   +   + +   +       +     + + +     +       +   +     +     +
+ +++ + +++++++++++++++++++++ + + +++++ +++++ + + + + + + +++++++++++ + +++ +++ + +++ +++++++ +++++ + + +++++ +++++++ +++++++++ +++++
+ +   +     +   +     +       + +   +   +   + + + +   + +     +     + +   + + +       +     + +   +   + +     +     +   +       +   +
+ + +++++++ + + + +++ + +++++ + +++ + + + + +++ + +++++++++++ + +++ + +++ + + +++++++++ +++++ + + + +++ + +++++++++ +++ + +++++++ + +
+   +       + +   +   +   + +   +   + + + +   + +       +   + + +   +   + + +   +     +     + + + + +   +   +     +   + + + +   + + +
+ +++ +++++++ +++++ +++++ + +++++ +++ +++ +++ + +++++++ + + + +++ + +++ + + + + +++++ +++++ + +++ + + +++ + + +++ +++ + + + + + +++ +
+     +     +   +   +     +     + +     + +   + +     + + + +   + +   +   + + +       +   + +       +   + +   + + +   +     + +     +
+++ +++ +++ +++ +++++++ +++++++ + + +++ + + +++ + +++ + +++ +++ + +++ +++++ + +++++++++ +++ +++++ +++++ + +++++ + + +++ +++ + +++++++
+ +   +   +           +         +   +     + +   + +   + +   +   +   + +     + +   +   + +   +           +       +   +   +   +   +   +
+ +++ +++ +++++ +++++ +++++++++++++++ + +++ + +++ + +++ + +++ +++ +++ + +++++ +++ +++ + + + + +++ + +++++++++++++++++++++ +++++ +++ +
+   + +   +     +   + +               +   +   +   +     +     +   +   + +   + +   +   +   +   +   + +       +   +     +   +     +   +
+ +++ + +++ +++++ +++ + +++++++++++++++++++++++ +++++++++ +++++++ + +++ + + + + +++ +++++ +++++++++ + + +++ + + + + + +++++ +++ + + +
+       +   +     +   +   +     +   + +   +       + +     +       + +   + +   +   + + +   +   +       +   +   +   + +   +     + + + +
+++++ +++ +++ +++++ +++++ + + + + + + + + + +++++ + + +++ + +++++++ + +++ + +++ + + + + +++ + + +++++++ +++++++++++ +++ + +++ + + + +
+   +   + +   +     +   + + + +   + +   +   +     + + +     +     +       +   + +   + +   + +   +       +   +   +     + + +   +   + +
+ +++++ + + +++ + +++ + + + + + +++ +++++++++ +++++ + + + +++++ +++++++++++++ +++ + + +++ + +++++ +++++++ + + + + +++++ + +++++++++ +
+       + +   + +     + +   + +   +   +     + +   +   + +       +           +   + + +     + +   + + +     + + +   +     +     +     +
+++++++++ +++ + +++++ +++++++ + +++++ + +++ + + + +++++ +++++++++ +++++++ +++++ + +++++++++ + + + + + + +++++ +++++ +++++++++ + +++++
+             +     +         +     +   +   +   +       +         +             +           + +   +   +       +               +   P +
+++++++++++++++++++++++++++++++++++++++++++++++++++++++++++++++++++++++++++++++++++++++++++++++++++++++++++++++++++++++++++++++++++++
