LLLLLLLLLLLLLLLLLLLLLLLLLLLLLLLLLLLLLLLLLLLLLLLLLLLLLLLLLLLLLLLLLLLLLLLLLLLLLLLLLLLLLLLLLLLLLLLLLLLLLLLLLLLLLLLLLLLLLLLLLLLLLLLLLLLLL
L     L   L       L   L       L   L             L L   L   L         L   L         L     L   L       L             L   L   L   L     L
LLLLL L LLL LLLLL L LLL LLLLL L LLL LLLLLLLLL L L L L L L L LLLLLLL LLL L LLLLLLL LLL L L L L L LLL L LLLLLLLLLLL L L L L L L L LLL L
L     L     L   L     L     L L     L   L   L L   L L   L   L       L   L   L   L L   L   L L L   L   L   L   L   L L   L L L   L L L
L LLLLLLL LLL L LLLLL LLLLLLL LLLLLLL LLL L L LLLLL LLLLLLLLL LLLLLLL LLLLL L LLL L LLLLLLL L LLL L LLL L L L L LLLLL LLL L LLLLL L L
L   L   L L L L       L     L L     L     L       L L L     L L     L L   L L     L     L   L   L L   L L   L L L   L L   L L     L L
L L L L L L L LLLLL LLL LLL L L LLL LLLLLLLLLLLLL L L L LLL L L LLL L L LLL L LLLLLLLLL L LLLLL L LLL L LLLLL L L L L L LLL L LLLLL L
L L   L L   L L   L       L   L L       L L     L L   L   L L L   L     L   L         L L     L L   L L   L   L   L L L   L     L   L
L LLLLL LLLLL LLL LLLLL LLLLLLL L LLLLL L L LLL L L LLLLL L L LLL LLLLL L LLLLLLLLL LLL LLLLL L LLL LLLLL L LLLLLLL L LLL LLL L L LLL
L   L   L   L   L L   L       L L     L L L L   L L       L L L       L     L       L   L   L L L   L     L   L   L   L   L   L L L L
LLL L LLL L LLL L L LLLLLLL L L LLLLL L L L L LLL LLLLLLLLL L LLLLLLLLLLL L L LLLLLLL LLLLL L L L LLL LLLLLLL L L LLLLLLLLLLLLLLL L L
L   L   L L     L L         L L   L L L L   L   L           L L       L   L L       L L     L L L L   L     L L L L   L       L   L L
L LLLLL L LLLLLLL LLLLLLLLL L LLL L L L LLL LLL LLLLLLLLL LLL L LLLLL LLLLL LLLLLLL L L LLL L L L L LLL LLL L L L L L L LLLLL L LLL L
L L   L   L     L   L       L     L   L       L L       L L   L     L   L   L       L L   L L L L L     L L L   L   L   L     L     L
L LLL L LLL LLL LLL L LLLLLLLLL LLLLLLLLLLLLLLL L LLLLLLL L LLLLLLL LLL L LLL LLLLLLL LLL LLL L L LLLLL L L LLL LLL LLLLL LLLLL LLLLL
L   L L L   L   L   L   L     L L       L       L L       L   L   L   L L   L L         L     L L   L   L L   L L   L   L     L L   L
L L L L L LLL LLL LLLLLLL LLL LLL LLLLL L LLLLLLL LLL LLLLLLL LLL LLL L LLL L L LLLLL LLLLLLLLL LLL L LLL LLL LLL LLL L LLL L L L L L
L L   L   L L     L     L   L       L   L             L   L   L   L L L     L   L   L   L   L   L   L L   L   L   L   L     L     L L
L LLLLLLLLL LLL LLLLLLL LLL LLLLL L LLLLLLLLLLLLL LLLLL L L LLL LLL L LLLLLLLLLLL L LLL L L L LLL LLL L LLL L L LLL L LLLLLLLLLLLLLLL
L L   L         L   L L     L   L L   L         L L     L   L   L   L   L     L   L L   L L   L   L   L L   L L L L L L     L   L   L
L LLL L LLLLLLLLL L L LLLLL L L L LLL L LLLLLLL LLL L LLLLLLL LLL L LLL L LLL L LLLLL LLL L LLL LLL LLL L LLLLL L L LLL LLL L L L L L
L     L     L     L   L     L L L L   L   L   L     L   L   L L L L       L   L L   L     L   L   L     L L       L       L L L L L L
LLLLLLLLLLL L LLLLL LLL LLLLL L L L L LLL LLL LLLLLLLLL L L L L L LLLLLLLLL LLL L L LLLLLLLLL L LLLLLLLLL L LLLLLLLLLLLLLLL L L L L L
L         L   L     L   L   L L   L L L L     L   L     L L L L L L   L   L     L L L         L L         L L L     L   L     L L L L
L LLLLLLLLLLLLL L LLL L L L LLLLLLLLL L LLLLLLL L L LLLLL L L L L LLL L L LLLLLLL LLL LLLLLLLLL L LLLLL LLL L L LLL LLL L LLLLL LLL L
L L       L     L L   L L L L   L L   L   L   L L   L L   L   L   L   L L L           L       L L   L   L   L   L   L   L   L L     L
L L LLLLL L LLLLLLL LLLLL L L L L L LLLLL L L L LLLLL L LLLLL L LLL LLL L L LLLLL LLLLL LLLLL L LLL L LLL LLLLLLL LLL LLLLL L LLLLLLL
L   L       L L   L   L   L L L L   L   L   L L L   L   L     L L   L   L   L   L       L     L L   L   L L   L L     L     L     L L
LLLLL LLLLLLL L L LLLLL L LLL L LLL L L LLL LLL L L L LLL LLLLL L LLLLL LLLLLLL LLL LLLLL LLLLL L LLLLLLL L L L LLL LLL LLLLL L L L L
L     L     L   L L   L L L   L   L L L   L   L   L   L     L   L     L   L   L   L L   L L     L L L     L L   L       L     L L   L
L LLLLL LLL LLLLL L L L LLL LLLLL L L LLL LLL LLLLLLLLLLLLL L LLLLLLL L L L L LLL LLL L L L LLLLL L L LLLLL LLLLL L LLL LLLLLLL LLLLL
L L     L L L   L   L   L   L     L L   L L L     L       L L L       L L   L     L   L   L   L   L         L     L L   L       L   L
L L LLLLL L L L LLLLL LLL LLL LLLLL LLL L L LLLLL L LLLLLLL L L LLLLL L LLLLLLL LLL LLLLLLLLL L LLLLL LLLLLLL LLLLL LLLLL LLL LLL LLL
L L L     L L L         L L   L     L   L   L   L L   L L   L L     L L L     L   L   L       L L   L L   L   L     L     L   L     L
L L L LLLLL LLLLLLLLLLL L L LLL LLLLLLL LLL L L L LLL L L LLL LLLLL L L L LLL LLL LLL L LLLLLLL LLL L L L L LLLLLLLLL LLL LLLLLLLLL L
L L L L   L   L     L   L L     L     L   L   L L L       L   L     L   L   L L L   L L L     L   L   L L L   L     L L L   L       L
L L L L L L L LLLLL L LLL LLLLLLL LLL L LLLLL LLL L L LLLLL LLLLLLLLLLLLLLL L L LLL L L LLLLL L L LLLLL L LLL L LLL L L LLL L LLLLLLL
L   L L L   L L     L   L L   L   L   L L   L L   L L       L       L     L L L L L L L     L L L   L   L L   L   L L L   L L L   L L
LLLLL LLL LLL L LLL LLL L L L L LLL LLLLL L L L LLL LLLLLLL L LLLLL L LLL L L L L L L LLLLL L LLLLL LLLLL L LLL LLL L L LLL L LLL L L
L   L   L   L L   L   L L   L L   L L   L L   L         L   L   L   L L   L L L L   L L   L L L   L L     L     L   L L   L L L   L L
L L LLL LLLLL LLL LLL L LLLLL L L L L L L LLLLLLLLLLLLL LLLLLLL L LLL L LLLLL L LLL L LLL L L L LLL L LLLLLLLLLLL LLL LLL L L L LLL L
L L   L           L     L   L   L L   L L   L   L L   L   L   L L     L L   L L     L   L       L   L L         L   L     L L L L   L
L LLL LLLLLLL LLLLL L LLL L LLLLL LLLLL LLL L L L L L LLL L L L LLLLLLL L L L LLLLLLLLL LLL LLLLL LLL LLLLLLLLL LLL LLLLLLL L L L LLL
L   L L       L     L     L L   L   L   L   L L   L L L   L L L   L   L L L   L         L   L   L   L       L         L   L L L L   L
LLLLL L LLL L L LLLLLLL LLL L L LLL L L L LLL LLLLL L LLLLLLL LLL L LLL L LLLLL LLLLLLLLL LLL L LLL LLLLLLL LLLLLLLLLLL L L L L LLL L
L L   L L   L L L       L L L L   L L L L L L       L             L   L L       L     L L   L L   L         L     L   L L   L L L   L
L L LLLLL LLLLL L LLLLLLL L L LLLLL L LLL L LLLLLLLLLLL LLLLLLLLLLLLL L LLLLLLLLL LLL L LLL L LLL LLLLLLL LLL LLL L L LLL LLL L L LLL
L         L     L L     L   L       L L   L L     L   L L   L L   L L L L       L   L L   L L   L   L     L   L   L L       L L L   L
LLLLLLLLLLL LLLLL L LLLLLLLLL L LLLLL L LLL L L LLL L L L L L L L L L L L LLLLL LLL L LLL L LLL LLL L L LLL LLL L L LLLLL L L L L L L
L       L   L     L       L   L L   L L   L L L     L   L L   L L   L   L L     L   L L   L   L   L   L     L   L L L     L   L   L L
L LLLLL L LLLLL LLLLLLLLL LLLLL LLL L LLL L LLL LLLLLLLLL LLLLL LLL L LLLLL LLLLL LLL L LLLLL LLL LLLLLLLLLLL LLLLL L LLLLLLLLLLLLL L
L     L   L   L L   L   L L   L   L L   L   L   L   L   L   L   L L   L   L L     L   L     L   L L       L     L   L L     L   L   L
LLLLL LLLLLLL L L L L L L L L L L L L L L LLL LLL L L L LLL L LLL LLLLL L L L LLLLLLL LLLLL LLL L L LLL LLL LLLLL LLL L LLL L L L LLL
L   L L       L   L L L     L L L   L L       L   L   L       L   L     L L L   L     L   L       L   L L   L   L L L   L L   L   L L
L L L LLLLL LLLLLLL LLLLL LLLLL LLLLLLLLLLLLLLL LLLLLLLLLLL LLL LLL LLLLL L LLL L LLLLL L LLLLL LLLLLLL L LLL L L L LLLLL LLL LLLLL L
L L   L   L L       L     L       L     L     L L   L   L L   L L   L     L   L L   L   L     L     L   L L   L   L L       L   L   L
L LLL L L L L L LLLLL LLLLL LLLLLLL LLL L LLL L LLL LLL L LLL L L LLL LLLLLLL L LLLLL LLLLLLL LLL LLL LLL LLLLL LLL L L LLL LLL L LLL
L L L   L L L L   L   L   L L     L L   L L   L     L   L     L L   L         L       L     L     L   L L   L   L   L L   L L   L   L
L L LLL L L L LLL L LLL L L L LLL L LLL LLL LLL LLLLL LLLLLLLLL LLL LLLLLLLLLLL LLLLLLL LLL LLLLL L LLL LLL L LLL LLL LLL L LLLLLLL L
L L L L L   L   L     L L   L   L L   L     L   L   L L   L   L L             L     L   L   L     L L   L   L   L L   L L L       L L
L L L L LLLLLLLLLLLLL L LLLLLLL L LLL LLLLLLL LLL LLL L L L L L LLLLL L LLLLLLLLLLL LLLLL L LLLLLLL L LLL L LLL L LLLLL L LLLLLLL L L
L   L L   L       L   L     L   L   L L       L   L     L L L   L     L       L   L L     L L       L   L L L   L   L           L   L
LLLLL LLLLL LLLLL L LLLLLLL L LLLLL L L LLLLLLL LLL L LLL L LLLLL LLLLLLLLLLL L L L L LLLLLLL LLLLL LLL LLL L LLLLL LLLLLLL LLLLLLLLL
L   L           L         L   L     L L     L L     L L L L     L L     L   L L L         L   L   L   L L   L L   L         L   L   L
L L LLLLL L LLLLLLLLLLLLLLLLL L L LLL LLLLL L LLLLLLL L L LLLLL L L LLL LLL L L LLL L LLLLL LLL L LLLLL L LLL L L L LLLLLLLLL L L LLL
L L       L   L   L           L L L   L   L L   L L   L   L     L L L   L   L L L   L L   L L   L       L L   L L       L L   L L   L
L LLLLLLLLLLL L L L LLLLLLLLLLL L L LLL LLL L L L L LLLLLLLLL LLLLL L LLL L L L L LLLLL L L L L LLLLLLL L L LLL LLL LLL L L LLL LLL L
L L   L   L L   L   L     L     L L   L L   L L   L     L   L L     L     L   L L       L   L L L   L L   L L   L L L   L L L   L   L
L L L L L L L LLLLLLLLL LLL LLLLL LLL L L LLL LLL LLL L L L L L LLLLL LLLLLLLLL LLLLLLLLLLLLL LLL L L LLLLL L LLL L LLLLL L LLLLL LLL
L L L L L   L     L   L     L L   L   L     L   L   L L   L     L   L     L     L     L L     L   L   L     L L   L   L     L       L
L L L L L LLLLLLL L L LLLLLLL L LLL LLLLL L LLL LLLLL LLLLLLL LLL L L LLL L LLLLL LLL L L LLLLL LLLLLLL LLLLL L LLLLL LLL LLL LLLLL L
L L L L L L   L L   L L   L   L     L   L L   L L   L L         L L L   L L     L   L L   L   L   L     L     L L         L   L L   L
L LLL L L L L L LLLLL LLL L LLLLLLLLLLL L LLL L L L L L LLLLLLLLL LLLLL LLLLLLL LLL L LLLLLLL LLL L LLLLL LLLLL L LLL LLLLL LLL L LLL
L       L   L   L   L   L     L     L   L L L     L L L           L   L   L         L   L   L   L L     L L     L L       L   L   L L
LLLLL LLLLLLLLL L LLLLL LLLLL LLLLL L LLL L LLLLLLL L L LLLLLLLLLLL LLLLL L LLLLLLLLLLL LLL LLL L LLL L L L LLLLL L L LLL L LLLLLLL L
L     L   L   L L     L   L   L   L   L   L       L   L     L     L       L       L   L     L         L   L   L   L L L   L     L   L
L LLLLLLL L L L L LLL LLL L LLL L L LLL LLLLLLL LLLLLLLLLLL L L LLLLLLLLLLLLLLLLL L LLL LLLLL L L LLLLLLLLL L LLLLL L L LLLLL L L LLL
L       L L L   L   L L   L   L L L L   L   L L     L L   L L L L             L   L     L   L L L     L   L L     L L L   L   L L   L
LLLLLLL L L LLLLLLL L LLL LLL L L L L LLLLL L LLLLL L L L L L L L LLLLLLLLLLL L LLLLLLLLL L LLL LLLLLLL L LLLLLLL L L LLL LLLLL LLL L
L     L L L L   L   L     L   L L L L     L L       L   L   L L   L   L     L   L     L   L   L       L L   L   L L L   L     L     L
L LLLLL L L L L L LLLLLLLLL L L L L LLLLL L LLLLL L LLLLLLLLL LLLLL L L LLL LLLLL LLL L LLLLL LLLLLLL L L L LLL L L LLL LLL LLLLLLL L
L       L   L L L       L   L L L   L   L L   L   L L       L     L L   L   L   L L   L   L L L     L   L L L   L   L   L           L
LLLLLLLLLLLLL L L L LLL L LLL L LLL L LLL LLL LLLLL L LLLLL L LLL L LLLLL LLLLL L L LLLLL L L L LLL LLLLL L L L LLLLL LLLLL LLLLLLL L
L         L   L   L L   L L L     L L   L L   L   L   L L   L   L L     L     L L L       L     L     L   L L L L   L L   L     L   L
L LLLLLLL L LLLLLLLLL L L L L LLL LLLLL L L LLL L LLLLL L LLLLL LLLLL L LLLLL L L LLL LLLLLLLLLLL LLLLL L L L L L L L LLL LLLLL LLL L
L   L   L L         L L   L L   L L   L     L   L L     L     L       L   L   L L L     L   L   L L     L L   L   L L     L L   L   L
L LLL L L LLLLLLLLL LLLLLLL LLL L L L LLL L LLLLL L L LLLLLLL LLLLLLLLL L L LLL L LLLLLLL L L L L L LLLLLLLLLLLLLLL L LLLLL L LLL LLL
L     L L           L   L   L   L L L     L L   L L L   L   L     L   L L L   L L   L     L L L L L L   L   L     L L     L   L     L
LLLLLLL LLLLLLLLLLLLL L L LLLLLLLLL LLLLLLLLL L L L LLL L L LLLLL LLL L L LLL L LLL L LLLLL LLL LLL L LLL L L LLLLL LLLLL LLLLL LLLLL
L   L   L   L     L   L   L       L   L     L L L   L L L L     L   L L L   L L L   L   L   L   L   L L   L L       L   L L L   L   L
L L L LLL L LLLLL L LLLLLLLLL LLL LLL LLLLL L L LLLLL L L LLLLL LLL L L LLL L L L L LLL L LLL LLL LLL L LLL LLLLLLLLL L L L L LLL L L
L L   L   L   L L L         L   L     L     L L           L   L     L L L   L   L L     L L       L   L   L L   L   L L L L L L L L L
L LLL L LLLLL L L L LLLLLLL LLL LLLLLLL LLLLL LLLLLLLLLLLLL L LLLLLLL LLL LLLLLLL LLLLLLL LLL L LLL LLL L L L L LLL L L L L L L L L L
L   L   L     L L L L L   L L   L   L   L       L L   L     L L   L       L     L L     L     L   L     L L L L   L   L   L L     L L
LLL LLLLL LLLLL L L L L L L L LLL L L LLL L L L L L L L LLLLL LLL L L L LLL LLL L L L L LLLLLLLLL LLLLLLL L L LLL LLLLLLLLL LLL LLL L
L L   L L L     L   L   L   L L   L L L   L L L     L L L     L   L L L L     L L L L L L   L     L   L   L L   L L       L     L   L
L LLL L L L LLLLLLLLLLLLLLL L LLL L L L LLLLL LLLLLLL L LLLLLLL LLL L L L LLL L L L LLL L LLL LLL L L LLLLL LLLLL LLL LLL LLLLLLL LLL
L L   L   L L                 L   L L   L     L       L   L     L   L L   L   L     L   L     L   L L   L           L L   L     L   L
L L LLLLLLL L LLLLLLLLLLLLL LLL L L L LLL L LLLLL LLLLLLL L LLLLLLLLLLLLLLL LLLLL LLL LLLLLLLLL LLL L L L LLLLLLLLL L L LLL LLL LLL L
L L L     L   L L       L       L L   L   L   L   L       L L     L   L   L L L   L   L       L     L L L     L   L   L   L L L   L L
L L L LLL LLLLL L L LLL L LLLLLLLLLLLLL LLLLLLL LLLLL LLLLL L LLL L L L L L L L LLL LLLLLLLLL LLLLLLL L LLLLL L LLLLLLL LLL L LLLLL L
L   L L L   L L   L   L L   L           L       L   L L   L L L   L L   L L L L L   L           L     L   L   L L     L L   L     L L
LLLLL L LLL L L LLLLLLL LLLLL LLLLLLLLL L LLL LLL L L L L L L LLLLLLLLL L L L L LLLLL LLLLLLL LLL LLLLLLL L LLL L LLL L L L L LLL L L
L   L L       L   L L   L     L       L L   L L   L   L L   L     L     L   L   L   L L   L     L   L   L L   L     L   L L   L L   L
L L L LLLLLLLLLLL L L LLL LLLLL LLLLL LLLLL LLL LLLLL L LLLLLLLLL L LLLLLLLLLLLLL L L L L LLLLL LLL L L L LLL LLLLLLLLLLL LLLLL LLLLL
L L   L L       L L     L           L     L   L     L L       L L L     L         L L L L     L     L L     L       L   L L   L     L
L LLLLL L LLLLL LLL LLLLLLLLLLL LLLLLLLLL LLL LLLLL L L LLLLL L L LLLLL L LLLLLLLLL L LLLLLLL LLL LLL LLLLLLLLLLL L LLL L LLL LLLLL L
L   L L   L   L L     L       L L       L   L       L L     L L   L     L L L       L     L         L         L   L     L   L   L   L
LLL L LLLLL L L L L LLL LLLLL LLL LLL L LLL LLL LLLLL LLLLLLL LLL L LLLLL L L LLLLLLLLLLL LLLLLLLLLLLLL LLLLL L LLLLLLLLLLL LLL L LLL
L   L L     L L   L   L L   L     L   L   L L   L   L   L   L   L L     L L L L L   L   L     L L     L L   L   L     L   L   L L L L
L L L L LLL LLLLL LLL L L L LLLLLLL LLL LLL L LLL L LLL L L LLL L LLLLLLL L L L L L LLL L LLL L L LLLLL L LLL LLLLLLL L L LLL L L L L
L L L L   L L   L   L L   L   L   L L L   L L     L   L   L     L       L   L L   L L   L L     L L L   L   L       L   L L   L L L L
L L L LLL L L LLLLL L LLLLL L L L L L LLL L LLLLLLLLL LLLLLLLLLLLLLLLLL LLLLL LLLLL L LLLLL LLLLL L L LLLLL LLLLLLL LLL L LLL L L L L
L L L L   L L       L       L L L L   L L   L     L L   L             L   L   L L   L       L     L L L     L       L   L     L     L
L LLL L LLLLLLLLLLLLLLLLLLLLL L L LLLLL LLLLL L L L L L L LLLLLLLLLLL L LLL LLL L LLL LLLLLLL LLLLL L L LLLLL LLLLLLL LLLLLLLLL LLLLL
L L   L     L   L     L       L L   L   L   L L L L   L L     L     L L   L L L       L     L L   L   L L     L     L   L       L   L
L L LLLLLLL L L L LLL L LLLLL L LLL L L L L LLL L LLLLLLLLLLL L LLL L LLL L L LLLLLLLLL LLLLL L L L LLL L LLLLLLLLL LLL L LLLLLLL L L
L   L       L L   L   L   L L   L   L L L L   L L       L   L L L   L   L L L   L     L     L L L L L   L   L     L   L L L L   L L L
L LLL LLLLLLL LLLLL LLLLL L LLLLL LLL LLL LLL L LLLLLLL L L L LLL L LLL L L L L LLLLL LLLLL L LLL L L LLL L L LLL LLL L L L L L LLL L
L     L     L   L   L     L     L L     L L   L L     L L L L   L L   L   L L L       L   L L       L   L L   L L L   L     L L     L
LLL LLL LLL LLL LLLLLLL LLLLLLL L L LLL L L LLL L LLL L LLL LLL L LLL LLLLL L LLLLLLLLL LLL LLLLL LLLLL L LLLLL L L LLL LLL L LLLLLLL
L L   L   L           L         L   L     L L   L L   L L   L   L   L L     L L   L   L L   L           L       L   L   L   L   L   L
L LLL LLL LLLLL LLLLL LLLLLLLLLLLLLLL L LLL L LLL L LLL L LLL LLL LLL L LLLLL LLL LLL L L L L LLL L LLLLLLLLLLLLLLLLLLLLL LLLLL LLL L
L   L L   L     L   L L               L   L   L   L     L     L   L   L L   L L   L   L   L   L   L L       L   L     L   L     L   L
L LLL L LLL LLLLL LLL L LLLLLLLLLLLLLLLLLLLLLLL LLLLLLLLL LLLLLLL L LLL L L L L LLL LLLLL LLLLLLLLL L L LLL L L L L L LLLLL LLL L L L
L       L   L     L   L   L     L   L L   L       L L     L       L L   L L   L   L L L   L   L       L   L   L   L L   L     L L L L
LLLLL LLL LLL LLLLL LLLLL L L L L L L L L L LLLLL L L LLL L LLLLLLL L LLL L LLL L L L L LLL L L LLLLLLL LLLLLLLLLLL LLL L LLL L L L L
L   L   L L   L     L   L L L L   L L   L   L     L L L     L     L       L   L L   L L   L L   L       L   L   L     L L L   L   L L
L LLLLL L L LLL L LLL L L L L L LLL LLLLLLLLL LLLLL L L L LLLLL LLLLLLLLLLLLL LLL L L LLL L LLLLL LLLLLLL L L L L LLLLL L LLLLLLLLL L
L       L L   L L     L L   L L   L   L     L L   L   L L       L           L   L L L     L L   L L L     L L L   L     L     L     L
LLLLLLLLL LLL L LLLLL LLLLLLL L LLLLL L LLL L L L LLLLL LLLLLLLLL LLLLLLL LLLLL L LLLLLLLLL L L L L L L LLLLL LLLLL LLLLLLLLL L LLLLL
L             L     L         L     L   L   L   L       L         L             L           L L   L   L       L               L     L
LLLLLLLLLLLLLLLLLLLLLLLLLLLLLLLLLLLLLLLLLLLLLLLLLLLLLLLLLLLLLLLLLLLLLLLLLLLLLLLLLLLLLLLLLLLLLLLLLLLLLLLLLLLLLLLLLLLLLLLLLLLLLLLLLLLLL
