+-----------+
|b         b|
|  4     4  |
|           |
|  p     p  |
|           |
|           |
|           |
|  p     p  |
|           |
|  4     4  |
|b         b|
+-----------+