21
+-+-+-+-+-+-+-+-+-+-+
|S   E|     S   |S  |
+-+-+ + +-+-+-+-+ + +
|   |    S|S|     | |
+ + +-+ + + + +-+-+ +
| | |  S|   |   |  S|
+ + + +-+-+ +-+ + +-+
|E|S| |   |S  | | |E|
+ +-+ + + +-+ + + + +
|     | |   |   |S| |
+-+-+-+ +-+-+-+-+ + +
|  S|   |   E   | | |
+ +-+ +-+ +-+-+ + + +
|      S|    S|   | |
+-+-+ + +-+-+ +-+ + +
|     |       |S|S| |
+-+ +-+-+ +-+-+ + + +
|   |  S|     | | | |
+ +-+ +-+-+-+ + + + +
| S |     E    S|  P|
+-+-+-+-+-+-+-+-+-+-+