UUUUUUUUUUUUUUUUUUUUU
Uq   *U     q   Uq  U
UUUUU U UUUUUUUUU U U
U   U    qUqU     U U
U U UUU U U U UUUUU U
U U U  qU   U   U  qU
U U U UUUUU UUU U UUU
U*UqU U   Uq  U U U*U
U UUU U U UUU U U U U
U     U U   U   UqU U
UUUUUUU UUUUUUUUU U U
U  qU   U   *   U U U
U UUU UUU UUUUU U U U
U      qU    qU   U U
UUUUU U UUUUU UUU U U
U     U       UqUqU U
UUU UUUUU UUUUU U U U
U   U  qU     U U U U
U UUU UUUUUUU U U U U
U q U     *    qU  PU
UUUUUUUUUUUUUUUUUUUUU